11111111
10P00001
1000C001
10C00C01
1000C001
100000E1
11111111
