111111111111111111111111111111111111111111
10PEC0000000000000000000000000000000000001
100000000000000000000000000000000000000001
1000000000000000000000000000000000000000C1
111111111111111111111111111111111111111111